11111111111111111111111111111111111111
10000000000000000000000000000000000CE1
10001000000000000000000000000000000CC1
10000000000000000000000000000000000001
100000CCCC0000000000000000000000000001
10000000000000000000000000000000000001
10000101100110111101100000000000000001
10000101011010100101010000000000000001
10000101000010111101010000000000000001
10000101000010100101100000000000000001
100000000000000P0100000000000000000001
100000000000CCCCC100000000000000000001
10000000000001110100001111000011100001
10000000000000010100001001000010000001
10000000000001110111111111111111100001
10000000000000000000000000000000000001
10000000000000000000000000000000000001
11111111111111111111111111111111111111